(no author) = no_author <no_author@no_author.cvs2svn>
ashinohara =  Andrew Shinohara <Andrew.Shinohara@fda.hhs.gov>
bauerd = bauerd <bauerd>
bhattarr = Ram Bhattaru <bhattarr>
boalt = boalt <boalt>
cais = Shuang Cai <cais>
chenhan = chenhan <chenhan>
chenhang = Hangjiong Chen <chenhang>
cvsuser = cvsuser <cvsuser>
georgeda = georgeda <georgeda>
glennje = glennje <glennje>
guruswas = Srinivasan Guruswami <srinivasan.guruswami@fda.hhs.gov>
harrismic = Harris Michael <harrismic>
jbeasley = Johnita Beasley <jbeasley>
kambampatim = Madhavi Kambampati <madhavi.kambampati@nih.gov>
khannaveed = Naveed Khan <khannaveed>
landyr = Ryan Landy <landyr>
lewisma2 = Mark Lewis <lewisma2>
liuh = liuh <liuh>
longyi = Ying Long <longyi>
manyamg = Ganiraju Manyam <manyamg>
mholck = Michael Holck <mholck@scenpro.com>
misquittal = Leonie Misquitta <leonie.misquitta@nih.gov>
mujus = mujus <mujus>
prakasht = Thaigarajan Prakash <thiagarajan.prakash@nih.gov>
root = root <root>
rossok = Kevin Rosso <Kevin.Rosso@fda.hhs.gov>
sahnih = Himanso Sahni <Himanso.Sahni@fda.hhs.gov>
svnuser = svnuser <svnuser>
ukapoor = Ujala Kapoor <ukapoor>
zhangd = Dana Zhang <zhangd>